
NO textures/NO.xpm

SO              textures/SO.xpm
WE       textures/WE.xpm

F 1,0,   0         




EA    textures/EA.xpm

C          255,       255, 255

111111111111111111111111111
11000000000000000000000000011
10000000000000D000000000000001
1000000000000000000000010000001
10000011111000010101000111111111
10000010001000000000001111111101
1000001000100001000100000000001      1
1000001000100000000000011111111
100000112110000101010001
100000000000000000000001
100000000000111100000001
100000000000011100000001
1000000N0000001100000001
100000000000000100000001
100000000000000000000001
100000030000000000000001
111111111000000000000001
110100001000000000000001
110000101000000000000001
110100001000000000000001
110111111000000000000001
110000000000000000000001
111111111000000000000001
111111111111111111111111