
NO textures/NO.xpm

SO              textures/SO.xpm
WE       textures/WE.xpm

F 0,10,   255         

C          0,       255, 255



EA    textures/EA.xpm


111111111111111111111111
1S0000000000000000000001
100000000000000000000001
100000000000000000000001
100000111110000101010001
100000100010000000000001
100000100010000100010001
100000100010000000000001
100000110110000101010001
100000000000000000000001
100000000000111100000001
100000000000011100000001
100000000000001100000001
100000000000000100000001
100000000000000000000001
100000000000000000000001
111111111000000000000001
110100001000000000000001
110000101000000000000001
110100001000000000000001
110111111000000000000001
110000000000000000000001
111111111000000000000001
111111111111111111111111
111111111111111111