
NO textures/NO.xpm

SO              textures/SO.xpm
WE       textures/WE.xpm

F 220,3,   111         


EA textures/EA.xpm

C 22, 22, 111

1111111111111111111111111
1000000000000000000000001
100000000000000000000000111111111
111111110000000000000000000000011
       10000000000000000000000011
111111111000000000000000000000001
10000000000000N000000000111111111
1000000000000000000000001
1000000000000000000000001
1111111111111111111111111