
NO textures/NO.xpm

SO              textures/SO.xpm
WE       textures/WE.xpm

F 1,0,   0         




EA    textures/EA.xpm

C   255,255, 255

1111111111111111111111111111    1111111111111
110000S0000000000000000000011   1000000000001
100000000000000000000000000001111000000000001
1K00000000000000000000010000000D000000000K001
100000100000000101010000000001111000000000001
100000100010000000000000000001  1000000000001
1111111000100001000100000000001 1111111111111
1111111000101000100000000000011
111111111D1100001111D1111111111
100000000001000100000001
10000000000010010000000111111111111111111111
10000000000001010000000D00000000000D00000001
100000000000001111D1111111111111111111111001
10000000000000010000000100000000000000000001
10000000000000000000000101111111111111111111
100000000000000000000001000000000K1
11111111100000000000000100000000001
110100001000000000000001111111111111
110000101000000000000001000000000001
110100001000000000000001000000000001
11011111100000000000000100000K000001
110000000000000000000001000000000001
11000000000000000000000D000000000001
111111111111111111111111111111111111