
NO ../textures/texture1.xpm

SO              ../textures/texture2.xpm
WE       ../textures/texture3.xpm

F 220,3,   111         


EA ../textures/texture4.xpm

C 22, 22, 111
11

     1111111111111111111111111
111111000110000000000001
1011000001110000000000111
10010000000000000011111 
11111111101101111111
11111110000001      111
    1  1000000111111110111111111111111
11110111111111011100000010001
1111011111111101110101001000111111
 111000000110101011100000010001
10000000000000001100000010001111
10000000000000001101010010000001       
11000001110101011111011110N0111
11110111 111010011111111111111111                  
11111111 1111111 111111111111