NO ../textures/texture1.xpm

SO              ../textures/texture2.xpm
WE       ../textures/texture3.xpm
EA ../textures/texture4.xpm






F 220,      100,0
C 225,30,0




     1111111111111111111111111111
111111000110000000000001
1011000001110000000000111
10010000000000000011111
11111111101101111111
11111110000001
      100000011111111111111111111111111
11110111111111011100000010001
11110111111111011101010010001
11000000110101011100000010001
10000000000000001100000010001xxxxxxxxxx
10000000000000001101010010000001
11000001110101011111011110N0111
11110111 1110101 101111010001
11111111 1111111 111111111111
